20000001200000012000000120000001200000012000000120000001200000012000000120000001200000012000000120000001200000012000000120000001200000012000000120000001200000012000000120000001
200000010000000f0000000f0000000f0000000f0000000f0000000f0000000f0000000f0000000f0000000f000000400000000f0000000f0000000f0000000f0000000f0000000f0000000f0000000f0000000f20000001
200000010000000f00000029000000290000000f0000000f0000000f0000000f0000000f0000000f0000000f000000d90000000f0000000f0000000f0000000f0000000f0000000f0000000f0000000f0000000f20000001
200000010000000f000000290000000f0000000f0000000f0000000f0000000f0000000f0000000f0000000f000000d90000000f0000000f0000000f0000000f0000000f0000000f0000000f0000000f0000000f20000001
200000010000000f0000000f0000000f0000000f0000000f0000000f0000000f0000000f0000000f0000000f000000d90000000f0000000f0000000f0000000f0000000f0000000f0000000f0000000f0000000f20000001
200000010000000f0000000f0000000f0000000f0000000f0000000f0000000f0000000f0000000f0000000f000000d90000000f0000000f0000000f0000000f0000000f0000000f0000000f0000000f0000000f20000001
200000010000000f0000000f0000000f0000000f0000000f0000000f0000000f0000000f0000000f0000000f000000d90000000f0000000f0000000f0000000f0000000f0000000f0000000f0000000f0000000f20000001
2000000100000000000000d9000000d9000000d9000000d9000000d9000000d9000000d9000000d9000000d9000000d9000000d9000200d9000000d9000000d9000000d9000000d9000000d9000000d9000000d92000002e
200000010000000f0000000f0000000f0000000f0000000f0000000f0000000f0000000f0000000f0000000f000000d90000000f0000000f0000000f0000000f0000000f0000000f0000000f0000000f0000000f20000001
200000010000000f0000000f0000000f0000000f0000000f0000000f0000000f0000000f0000000f0000000f000000d90000000f0000000f0000000f0000000f0000000f0000000f0000000f0000000f0000000f20000001
200000010000000f0000000f0000000f0000000f0000000f0000000f0000000f0000000f0000000f0000000f200000d90000000f0000000f0000000f0000000f0000000f0000000f0000000f0000000f0000000f20000001
200000010000000f0000000f0000000f0000000f0000000f0000000f0000000f0000000f0000000f0000000f000000d90000000f0000000f0000000f0000000f0000000f0000000f0000000f0000000f0000000f20000001
200000010000000f0000000f0000000f0000000f0000000f0000000f0000000f0000000f0000000f0000000f000000d90000000f0000000f0000000f0000000f0000000f0000000f0000000f000000290000000f20000001
200000010000000f0000000f0000000f0000000f0000000f0000000f0000000f0000000f0000000f0000000f000000d90000000f0000000f0000000f0000000f0000000f0000000f00000029000000290000000f2000000f
200000010000000f0000000f0000000f0000000f0000000f0000000f0000000f0000000f0000000f0000000f0000002e0000000f0000000f0000000f0000000f0000000f0000000f0000000f0000000f0000000f20000001
2000000100000001000000010000000100000001000000010000000f0000000f0000000f0000000f000000010000000100000001000000010000000100000001000000012000000120000001200000012000000120000001
