a00000018000000180000001800000018000000180000001800000018000000180000001800000018000000180000001800000018000000180000001800000018000000180000001
8000000100000000000000000000000000000000000000000000000000000000000000000000000000000000000000000000000000000000000000000000000000000000a0000001
800000010000000000000000000000000000000000000000000000000000000000000000000000000000000000000000000000000000000000000000000000000000000080000001
800000010000000000000000000000000000000000000000000000000000000000000000000000000000000000000000000000000000000000000000000000000000000080000001
800000010000000000000000000000000000000000000000000000000000000000000000000000000000000000000000000000002000000100000000000000000000000080000001
800000010000000000000000000000000000000000000000000000000000000000000000000000000000000000000000000000000000000000000000000000000000000080000001
800000010000000000000000000000000000000020000001000000000000000000000000000000000000000000000000000000000000000000000000000000000000000180000001
800000010000000000000000000000000000000000000000000000000000000000000000000000000000000020000001000000000000000000000000000000000000000180000001
800000010000000000000000000000000000000000000000000000000000000000000000000000000000000000000001000000000000000000000000000000000000000180000001
800000010000000000000000000000000000000000000000000000000000000000000000000000000000000000000001000000000000000000000000000000000000000180000001
800000010000000000000000000000000000000000000000000000000000000000000000000000000000000000000001000000000000000000000000000000010000000180000001
800000010000000000000000000000000000000000000000000000000000000000000000000000000000000000000001000000000000000000000000000000012000000180000001
800000010000000000000000000000010000000000000001000000000000000000000000000000000000000000000001000000000000000000000000000000010000000180000001
800000010000000000000000000000000000000000000000000000000000000000000000000000000000000000000000000000000000000000000000000000000000000180000001
800000010000000000000001000000000000000000000000000000010000000000000000000000000000000000000000000000000000000000000000000000000000000180000001
800000010000000000000000000000010000000100000001000000000000000000000000000000000000000000000000000000000000000000000000000000000000000080000001
800000010000000000000000000000000000000000000000000000000000000000020000000000000000000000000000000000000000000000000000000000000000000080000001
800000010000000000000000000000000000000000000000000000000000000000000000000000000000000000000000000000000000000000000000000000000000000080000001
800000010000000000000000000000000000000000000001000000000000000000000000000000000000000000000000000000000000000000000000000000000000000080000001
800000010000000000000000000000002000000100000001000000000000000000000000000000000000000020000001000000000000000000000000000000000000000080000001
800000010000000000000000000000000000000100000000000000000000000000000000000000000000000000000000000000000000000000000000000000000000000080000001
800000010000000000000000000000000000000000000000000000000000000000000000000000030000000000000000000000000000000000000000000000000000000080000001
800000010000000000000000000000000000000000000000000000000000000000000000000000000000000000000000000000000000000000000000000000000000000180000001
800000010000000000000000000000000000000000000000000000000000000000000000000000000000000000000000000000000000000000000000000000000000000180000001
800000010000000000000000000000000000000000000000000000000000000000000000000000000000000000000000000000000000000000000000000000000000000180000001
800000018000000180000001800000018000000180000001800000018000000180000001800000018000000180000001800000018000000180000001800000018000000180000001
