800000068000000880000008800000088000000880000008800000088000000880000008800000088000000880000008800000088000000880000008800000088000000880000009
800000190000000000000000000000000000000000000000000000000000000000000000000000000000000000000000000000000000000000000000000000000000000080000019
800000190000000000000000000000000000000000000000000000000000000000000000000000000000000000000000000000000000000000000000000000000000000080000019
800000190000000000000000000000000000000000000000000000000000000000000000000000000000000000000000000000000000000000000000000000000000000080000019
800000190000000000000000000000000000000000000000000000000000000000000000000000000000000000000000000000000000000000000000000000000000000080000019
800000190000000000000000000000000000000000000000000000000000000000000000000000000000000000000000000000000000000000000000000000000000000080000019
800000190000000000000000000000000000000000000000000000000000000000000000000000000000000000000000000000000000000000000000000000000000000080000019
800000190000000000000000000000000000000000000000000000000000000000000000000000000000000000000000000000000000000000000000000000000000000080000019
800000190000000000000000000000000000000000000000000000000000000000000000000000000000000000000000000000000000000000000000000000000000000080000019
800000190000000000000000000000000000000000000000000000000000000000000000000000000000000000000000000000000000000000000000000000000000000080000019
800000190000000000000000000000000000000000000000000000000000000000000000000000000000000000000000000000000000000000000000000000000000000080000019
800000190000000000000000000000000000000000000000000000000000000000000000000000000000000000000000000000000000000000000000000000000000000080000019
800000190000000000000000000000000000000000000000000000000000000000000000000000000000000000000000000000000000000000000000000000000000000080000019
800000190000000000000000000000000000000000000000000000000000000000000000000000000000000000000000000000000000000000000000000000000000000080000019
800000190000000000000000000000000000000000000000000000000000000000000000000000000000000000000000000000000000000000000000000000000000000080000019
800000190000000000000000000000000000000000000000000000000000000000000000000000000000000000000000000000000000000000000000000000000000000080000019
800000190000000000000000000000000000000000000000000000000000000020000011000000000000000000000000000000000000000000000000000000000000000080000019
800000190000000000000000000000000000000000000000000000000000000000000000000000000000000000000000000000000000000000000000000000000000000080000019
800000190000000000000000000000000000000000000000000000000000000000000000000000000000000000020000000000000000000000000000000000000000000080000019
800000190000000000000000000000000000000000000000000000000000000000000000000000000000000000000000000000000000000000000000000000000000000080000019
800000190000000000000000000000000000000000000000000000000000000000000000000000000000000000000000000000000000000000000000000000000000000080000019
800000190000000000000000000000000000000000000000000000000000000000000000000000030000000000000000000000000000000000000000000000000000000080000019
800000190000000000000000000000000000000000000000000000000000000000000000000000000000000000000000000000000000000000000000000000000000000080000019
800000190000000000000000000000000000000000000000000000000000000000000000000000000000000000000000000000000000000000000000000000000000000000000019
800000190000000000000000000000000000000000000000000000000000000000000000000000000000000000000000000000000000000000000000000000000000000080000019
800000168000001880000018800000188000001880000018800000188000001880000018800000188000001880000017800000178000001880000018800000188000001880000018
