20000001200000012000000120000001200000012000000120000001200000012000000120000001200000012000000120000001200000012000000120000001200000012000000120000001200000012000000120000001
200000010000000f0000000f00000000000000000000000000000000000000000000000f0000000f0000000f000000400000000f0000000f0000000f0000000f000000000000000f000000000000000f0000000020000001
200000010000000f20000029200000290000000f0000000f0000000f000000000000000f000000000000000f000000d90000000f000000000000000f0000000f0000000f0000000f0000000f0000000f0000000f20000001
200000010000000f2000002900000000000000000000000f0000000f00000000000000000000000f0000000f000000d90000000f000000000000000f000000000000000f0000000f0000000f000000000000000f20000001
200000010000000f0000000f0000000f0000000f0000000f00000000000000000000000f0000000f0000000f000000d9000000000000000f000000000000000f0000000f0000000000000000000000000000000f20000001
200000010000000f0000000f0000000f000000000000000f0000000f0000000f0000000f0000000f0000000f000000d9000000000000000f00000000000000000000000f0000000f000000000000000f0000000f20000001
200000010000000f0000000f000000000000000f000000000000000f000000000000000f000000000000000f000000d9000000000000000f0000000f0000000f0000000f000000000000000f0000000f0000000f20000001
2000000100000000000000d9000000d9000000d9000000d9000000d9000000d9000000d9000000d9000000d9000000d9000000d9000200d9000000d9000000d9000000d9000000d9000000d9000000d9000000d92000002e
200000010000000f0000000f000000000000000f0000000f0000000f0000000f0000000f0000000f0000000f000000d90000000f0000000f0000000f000000000000000f000000000000000f000000000000000020000001
2000000100000000000000000000000f0000000f0000000f0000000f0000000f000000000000000f0000000f000000d9000000000000000f0000000f0000000f000000000000000f000000000000000f0000000f20000001
200000010000000f0000000f00000000000000000000000f0000000f000000000000000f0000000f0000000f200000d9000000000000000f0000000f0000000f0000000f0000000f0000000f0000000f0000000f20000001
200000010000000f00000000000000000000000f0000000f00000000000000000000000f0000000000000000000000d90000000f0000000f0000000f000000000000000f0000000f0000000f0000000f0000000f20000001
200000010000000f0000000f000000000000000f000000000000000f0000000f0000000f0000000000000000000000d90000000000000000000000000000000f0000000f0000000f00000000200000290000000f20000001
200000010000000f00000000000000000000000f0000000f0000000f0000000f0000000f0000000f00000000000000d9000000000000000000000000000000000000000f0000000020000029200000290000000f00000000
200000010000000f0000000f0000000f000000000000000f0000000f0000000f00000000000000000000000f0000002e0000000f0000000f0000000f00000000000000000000000f000000000000000f0000000f20000001
20000001000000010000000100000001000000010000000100000000000000000000000f0000000f000000010000000100000001000000010000000100000001000000012000000120000001200000012000000120000001
