00000001000000010000000100000001000000010000000100000001000000010000000100000001000000010000000100000001000000010000000100000001000000010000000100000001000000010000000100000001
000000010000000000000000000000000000000000000000000000000000000000000000000000000000000f000000400000000f000000000000000000000000000000000000000000000000000000000000000000000001
000000010000000f20000029200000290000000f0000000f0000000f00000000000000000000000000000000000000d900000000000000000000000000000000000000000000000000000000000000000000000000000001
0000000100000000200000290000000000000000000000000000000f00000000000000000000000000000000000000d900000000000000000000000000000000000000000000000f00000000000000000000000f00000001
000000010000000f0000000f000000000000000f00000000000000000000000000000000000000000000000f000000d90000000000000000000000000000000f000000000000000000000000000000000000000000000001
00000001000000000000000f0000000000000000000000000000000000000000000000000000000000000000000000d9000000000000000000000000000000000000000f0000000f000000000000000f0000000000000001
00000001000000000000000f000000000000000000000000000000000000000000000000000000000000000f000000d90000000000000000000000000000000f0000000f0000000000000000000000000000000000000001
0000000100000000000000d9000000d9000000d9000000d9000000d9000000d9000000d9000000d9000400d9000000d9000000d9000200d9000000d9000000d9000000d9000000d9000000d9000000d9000000d90000002e
00000001000000000000000f00000000000000000000000f0000000f0000000f0000000f0000000f00000000000000d9000000000000000f0000000f00000000000000000000000000000000000000000000000000000001
0000000100000000000000000000000f000000000000000f0000000000000000000000000000000f00000000000000d9000000000000000000000000000000000000000000000000000000000000000f0000000000000001
000000010000000f0000000000000000000000000000000000000000000000000000000f0000000f0000000f000000d9000000000000000000000000000000000000000f000000000000000f0000000f0000000000000001
000000010000000f0000000000000000000000000000000f00000000000000000000000f0000000000000000000000d900000000000000000000000f000000000000000f0000000f0000000f000000000000000000000001
000000010000000000000000000000000000000f0000000000000000000000000000000f0000000000000000000000d90000000000000000000000000000000f000000000000000f00000000200000290000000f00000001
000000010000000000000000000000000000000f00000000000000000000000f000000000000000000000000000000d9000000000000000000000000000000000000000f0000000020000029200000290000000000000000
000000010000000f0000000f0000000f0000000000000000000000000000000f0000000000000000000000000000002e0000000f000000000000000f00000000000000000000000f00000000000000000000000000000001
00000001000000010000000100000001000000010000000100000000000000000000000f0000000f000000010000000100000001000000010000000100000001000000010000000100000001000000010000000100000001
