a000000ba000000ba000000ba000000ba000000ba000000ba000000ba000000ba000000ba000000ba000000ba000000ba000000ba000000ba000000ba000000ba000000ba000000b
a000001a00000000000000000000000000000000000000000000000000000000000000000000000000000000000000000000000000000000000000000000000000000000a000001a
a000000100000000000000000000000000000000000000000000000000000000000000000000000000000000000000000000000000000000000000000000000000000000a000001a
a000001a00000000000000000000000000000000000000000000000000000000000000000000000000000000000000000000000000000000000000000000000000000000a000001a
a000001a00000000000000000000000000000000000000000000000000000000000000000000000000000000000000000000000020000001000000000000000000000000a000001a
a000001a00000000000000000000000000000000000000000000000000000000000000000000000000000000000000000000000000000000000000000000000000000000a000001a
a000001a00000000000000000000000000000000200000010000000000000000000000000000000000000000000000000000000000000000000000000000000000000001a000001a
a000001a000000000000000000000000000000000000000000000000000000000000000000000000000000002000002b0000000000000000000000000000000000000001a000001a
a000001a00000000000000000000000000000000000000000000000000000000000000000000000000000000200000010000000000000000000000000000000000000001a000001a
a000001a00000000000000000000000000000000000000000000000000000000000000000000000000000000200000010000000000000000000000000000000000000001a000001a
a000001a00000000000000000000000000000000000000000000000000000000000000000000000000000000200000010000000000000000000000000000000100000001a000001a
a000001a00000000000000000000000000000000000000000000000000000000000000000000000000000000200000010000000000000000000000000000000120000001a000001a
a000001a00000000000000002000000100000000200000010000000000000000000000000000000000000000200000010000000000000000000000000000000100000001a000001a
a000001a00000000000000000000000000000000000000000000000000000000000000000000000000000000000000000000000000000000000000000000000000000001a000001a
a000000100000000200000010000000000000000000000002000000100000000000000000000000000000000000000000000000000000000000000000000000000000001a000001a
a000001a00000000000000002000000120000001200000010000000000000000000000000000000000000000000000000000000000000000000000000000000000000000a000001a
a000001a00000000000000000000000000000000000000000000000000000000000200000000000000000000000000000000000000000000000000000000000000000000a000001a
a000001a00000000000000000000000000000000000000000000000000000000000000000000000000000000000000000000000000000000000000000000000000000000a000001a
a000001a00000000000000000000000000000000200000010000000000000000000000000000000000000000000000000000000000000000000000000000000000000000a000001a
a000001a00000000000000000000000020000001200000010000000000000000000000000000000000000000200000010000000000000000000000000000000000000000a000001a
a000001a00000000000000000000000020000001000000000000000000000000000000000000000000000000000000000000000000000000000000000000000000000000a000001a
a000001a00000000000000000000000000000000000000000000000000000000000000002000000300000000000000000000000000000000000000000000000000000000a000001a
a000001a00000000000000000000000000000000000000000000000000000000000000000000000000000000000000000000000000000000000000000000000000000001a000001a
a000001a00000000000000000000000000000000000000000000000000000000000000000000000000000000000000000000000000000000000000000000000000000001a000001a
a000001a00000000000000000000000000000000000000000000000000000000000000000000000000000000000000000000000000000000000000000000000000000001a000001a
a000001aa000001aa000001aa000001aa000001aa000001aa000001aa000001aa000001aa000001aa000001aa000001aa000001aa000001aa000001aa000001aa000001aa000001a
