20000001200000012000000120000001200000012000000120000001200000012000000120000001200000012000000120000001200000012000000120000001200000012000000120000001200000012000000120000001
20000001000000000000000000000000000000000000000000000000000000000000000000000000000000000000002e00000000000000000000000000000000000000000000000000000000000000000000000020000001
20000001000000000000000000000000000000000000000000000000000000000000000000000000000000000000002e00000000000000000000000000000000000000000000000000000000000000000000000020000001
20000001000000000000000000000000000000000000000000000000000000000000000000000000000000000000002e00000000000000000000000000000000000000000000000000000000000000000000000020000001
20000001000000000000000000000000000000000000000000000000000000000000000000000000000000000000002e00000000000000000000000000000000000000000000000000000000000000000000000020000001
20000001000000000000000000000000000000000000000000000000000000000000000000000000000000000000002e00000000000000000000000000000000000000000000000000000000000000000000000020000001
20000001000000000000000000000000000000000000000000000000000000000000000000000000000000000000002e00000000000000000000000000000000000000000000000000000000000000000000000020000001
20000001000000000000000000000000000000000000000000000000000000000000000000000000000000000000002e0000000000000000000000000000000000000000000000000000000000000000000000002000002e
200000010000002e0000002e0000002e0000002e0000002e0000002e0000002e0000002e0000002e0000002e0000002e0000002e0000002e0000002e0000002e0000002e0000002e0000002e0000002e0000002e20000001
20000001000000000000000000000000000000000000000000000000000000000000000000000000000000000000002e00000000000000000000000000000000000000000000000000000000000000000000000020000001
20000001000000000000000000000000000000000000000000000000000000000000000000000000000000002000002e00000000000000000000000000000000000000000000000000000000000000000000000020000001
20000001000000000000000000000000000000000000000000000000000000000000000000000000000000000000002e00000000000000000000000000000000000000000000000000000000000000000000000020000001
20000001000000000000000000000000000000000000000000000000000000000000000000000000000000000000002e00000000000000000000000000000000000000000000000000000000000000000000000020000001
20000001000000000000000000000000000000000000000000000000000000000000000000000000000000000000002e00000000000000000000000000000000000000000000000000000000000000000000000020000001
20000001000000000000000000000000000000000000000000000000000000000000000000000000000000000000002e00000000000000000000000000000000000000000000000000000000000000000000000020000001
20000001000000010000000100000001000000010000000100000001000000010000000100000001000000010000000100000001000000010000000100000001000000012000000120000001200000012000000120000001
