20000001200000012000000120000001200000012000000120000001200000012000000120000001200000012000000120000001200000012000000120000001200000012000000120000001200000012000000120000001
20000001000000000000000000000000000000000000000000000000000000000000000000000000000000000000002e00000000000000000000000000000000000000000000000000000000000000000000000020000001
2000000100000000000000000000000000000000000000000000000000000000000000000000000000000000000000d900000000000000000000000000000000000000000000000000000000000000000000000020000001
2000000100000000000000000000000000000000000000000000000000000000000000000000000000000000000000d900000000000000000000000000000000000000000000000000000000000000000000000020000001
2000000100000000000000000000000000000000000000000000000000000000000000000000000000000000000000d900000000000000000000000000000000000000000000000000000000000000000000000020000001
2000000100000000000000000000000000000000000000000000000000000000000000000000000000000000000000d900000000000000000000000000000000000000000000000000000000000000000000000020000001
2000000100000000000000d90000000000000000000000000000000000000000000000000000000000000000000000d900000000000000000000000000000000000000000000000000000000000000000000000020000001
2000000100000000000000d9000000d9000000d9000000d9000000d9000000d9000000d9000000d9000000d9000000d9000000d9000000d9000000d9000000d9000000d9000000d9000000d9000000d9000000d92000002e
200000010000002e0000002e0000002e0000002e0000002e0000002e0000002e0000002e000000d80000002e000000d90000002e0000002e0000002e0000002e0000002e0000002e0000002e0000002e0000002e20000001
2000000100000000000000000000000000000000000000000000000000000000000000000000000000000000000000d900000000000000000000000000000000000000000000000000000000000000000000000020000001
2000000100000000000000000000000000000000000000000000000000000000000000000000000000000000200000d900000000000000000000000000000000000000000000000000000000000000000000000020000001
2000000100000000000000000000000000000000000000000000000000000000000000000000000000000000000000d900000000000000d90000000000000000000000000000002e00000000000000000000000020000001
2000000100000000000000000000000000000000000000000000000000000000000000000000000000000000000000d900000000000000000000000000000000000000000000000000000000000000000000000020000001
2000000100000000000000000000000000000000000000000000000000000000000000000000000000000000000000d900000000000000000000000000000000000000000000000000000000000000000000000020000001
20000001000000000000000000000000000000000000000000000000000000000000000000000000000000000000002e00000000000000000000000000000000000000000000000000000000000000000000000020000001
20000001000000010000000100000001000000010000000100000001000000010000000100000001000000010000000100000001000000010000000100000001000000012000000120000001200000012000000120000001
